border_size=1
usage=map

Ms          , Ha^Fpa      , Ha          , Aa          , Aa          , Aa          , Ww          , Aa          , Aa          , Gg          , Aa          , Gg          , Aa          , Aa^Fpa      , Aa          , Gg          , Aa          , Aa^Fpa      , Aa          , Aa          , Ha^Fpa      , Ms          
Ms          , Ha          , Ms          , Ha          , Ai          , Ai          , Gg^Efm      , Gg^Efm      , Aa^Fpa      , Gg          , Aa          , Gg          , Aa          , Aa^Fpa      , Aa          , Gg          , Gg          , Aa          , Ha          , Ha          , Ms          , Ms          
Ms          , Ms          , Ms          , Ha          , Ai          , Ww          , Aa          , Ha          , Mm          , Aa          , Hh          , Gg          , Gg          , Gg          , Gg          , Aa          , Gg          , Aa          , Ha          , Ms          , Ha^Fpa      , Ms          
Ms          , Ha^Fpa      , Ha          , Ha^Fpa      , Gg          , Gg          , Gg          , Aa^Fpa      , Hh          , Hh^Fp       , Gg          , Gg          , Gg          , Aa          , Aa          , Aa          , Gg          , Aa          , Ha          , Ms          , Ha^Fpa      , Ms          
Ms          , Ha^Fpa      , Aa          , Gg          , Gg^Efm      , Gg          , Gg          , Aa^Gvs      , Ha^Vhha     , Aa^Fpa      , Gg          , 3 Cv        , Gg          , Gg          , Gg          , Gg          , Re^Gvs      , Gg          , Aa          , Ha          , Ha          , Ms          
Ms          , Ha          , Aa          , Gg^Efm      , Ww          , Ww          , Ww          , Gs          , Gs          , Gg          , Gg^Efm      , Gg          , Gs^Fp       , Aa^Gvs      , Hh          , Gg          , Gg          , Gg          , Aa          , Ha          , Ms          , Ms          
Ms          , Ha          , Ha^Fpa      , Gg^Efm      , Gg^Efm      , Hh^Fp       , Mm          , Gd          , Gs          , Gs          , Gg^Efm      , Wwf         , Ww          , Aa^Vha      , Hh          , Gs^Fp       , Gg          , Gg          , Gs          , Gd          , Ha^Fpa      , Ms          
Ms          , Ha          , Ha          , Aa          , Gg^Efm      , Hh          , Gg          , Gs          , Gg^Efm      , Gs          , Gs          , Gg^Efm      , Wwf         , Gs^Fp       , Hh^Fp       , Mm          , Gg          , Gg          , Gg          , Ha          , Ms          , Ms          
Ms          , Ms          , Ha^Fpa      , Aa          , Gg          , Gg          , Gg          , Gg^Efm      , Aa^Fpa      , Gg^Efm      , Gs          , Gg^Efm      , Gg^Efm      , Gg^Efm      , Gg          , Gg          , Re^Gvs      , Re^Gvs      , Gs          , Ha          , Ha          , Ms          
Ms          , Ms          , Ha          , Gs          , Re^Gvs      , Re^Gvs      , Gg^Efm      , Hh^Fp       , Aa^Vea      , Aa^Fpa      , Gd          , Gs          , Gg          , Gg          , Ai          , Gg          , Gg          , Re^Gvs      , Gs          , Gd          , Ms          , Ms          
Ms          , Ha^Fpa      , Aa          , Gg          , Gg          , Re^Gvs      , Re^Gvs      , Gg^Efm      , Gg^Efm      , Aa^Gvs      , Ha^Fpa      , Gs          , Gg          , Ai          , Ww          , Ww          , Ds          , Gg          , Gs          , Ha          , Ha          , Ms          
Ms          , Ha^Fpa      , Ms          , Gg          , Gg          , Mm          , Hh          , Gg          , Gg          , Aa^Gvs      , Gg          , Gg          , Gg          , Ai          , Ha          , Ai          , Gg          , Gg          , Gs          , Ha          , Ms          , Ms          
Ms          , Ms          , Ha          , Aa          , Gg          , Gs^Fp       , Gg          , Gg          , Gg          , Gg          , Gs          , Gs          , Gg          , Gg          , Ha^Fpa      , Aa^Vea      , Gg          , Gs          , Ha^Fpa      , Ha^Fpa      , Ms          , Ms          
Ms          , Ms          , Aa          , Gg          , Gg          , Gg          , Gg          , Gg          , Gg          , Gs          , Ai          , Ai          , Ai          , Gg          , Gg          , Aa^Gvs      , Gg          , Gs          , Gd          , Ha          , Ha          , Ms          
Ms          , Ms          , Aa          , Gg          , Gg          , Gg          , Ha^Fpa      , Aa^Gvs      , Gg          , Ai          , Ww          , Ww          , Ai          , Gs          , Gg          , Gg          , Re^Gvs      , Gs          , Gd          , Ms          , Ha          , Ms          
Ms          , Ha^Fpa      , Gs          , Gs          , Gg          , Ha          , Aa^Vea      , Gg^Efm      , Gg          , Ai          , Ww          , Ww          , Ww          , Ai          , Gg          , Re^Gvs      , Gg          , Gg          , Gs          , Ha          , Ms          , Ms          
Ms          , Ha          , Aa          , Gg          , Gg          , Aa^Gvs      , Gg^Efm      , Gg^Efm      , Gg          , Ai          , Ww          , Ww          , Ww          , Ai          , Gg          , Re^Gvs      , Gg^Efm      , Gg^Efm      , Gg^Efm      , Gg          , Ha          , Ms          
Ms          , Ha^Fpa      , Ha          , Gg          , Gg          , Gg          , Re^Gvs      , Re^Gvs      , Gg          , Ai          , Ww          , Ww          , Ww          , Ai          , Gg          , Gg          , Aa^Vea      , Aa^Fpa      , Gg          , Gg          , Ha^Fpa      , Ms          
Ms          , Ha          , Ha          , Aa          , Gg          , Re^Gvs      , Aa^Gvs      , Aa^Gvs      , Gs          , Ai          , Ai          , Ww          , Ai          , Ai          , Gg          , Gg^Efm      , Aa^Gvs      , Aa^Gvs      , Gg          , Ha^Fpa      , Ha          , Ms          
Ms          , Ms          , Ha          , Ha^Fma      , Gg          , Re^Gvs      , Gg          , Gg          , Gd          , Gd          , Ai          , Ww          , Gd          , Gs          , Gd          , Gg          , Gs          , Gg          , Ha          , Ha          , Ms          , Ms          
Ms          , Ms          , Ha          , Aa          , Gg          , Gg          , Gg          , Gs          , Gs          , 1 Gs        , Ai          , Ai          , Gs          , 2 Gs        , Gs          , Gs          , Gg          , Gg          , Ha^Fpa      , Ms          , Ha          , Ms          
Ms          , Ms          , Ha          , Aa          , Aa          , Aa          , Gg          , Gg          , Gg          , Gs          , Gg          , Ai          , Gg          , Gs          , Gg          , Aa          , Aa          , Aa          , Aa          , Ms          , Ms          , Ms          
