border_size=1
usage=map

Gg          , Gg          , Gg          , Gg          , Gg          , Gg          , Re^Gvs      , Gg          , Gg          , Gg          , Ggf         , Gg          , Re^Gvs      , Gg          , Re^Gvs      , Gg          , Gs^Fds      , Hh          , Hh          , Hh          
Gs^Fds      , Gg          , Gs^Fds      , Gs^Fds      , Gs^Fds      , Gg          , Re^Gvs      , Re^Gvs      , Ggf         , Ggf         , Gg          , Ggf         , Gg          , Re^Gvs      , Gg          , Gg          , Gg          , Gs^Fds      , Gs^Fds      , Hh          
Gg          , Gg          , Ggf         , Hh          , Gg          , Gg          , Gg          , Gg          , Rr          , Gg          , Rr          , Rr          , Rr          , Gg          , Rr          , Gg          , Ggf         , Gg          , Gg          , Hh          
Hh          , Gg          , Ggf         , Ggf         , Gg          , Gg          , Rr          , Rr          , Ch          , Rr          , Ch          , Ch          , Rr          , Rr          , Ch          , Rr          , Gg          , Ggf         , Re^Gvs      , Gg          
Gg          , Gg          , Gg          , Gg          , Rr          , 1 Kh        , Rr          , Ch          , Rr          , Rr          , Rr          , Rr          , Rr          , Ch          , Ch          , Rr          , Rr          , Ggf         , Ggf         , Gg          
Re^Gvs      , Ggf         , Rr          , Rr          , Ch          , Rd          , Rd          , Rd          , Rd          , 3 Rp^Vhc    , Rd          , Rr          , Rr          , Rr          , Rr          , Rr          , Ch          , Rr          , Gg          , Gg          
Ggf         , Ggf         , Rr          , Ch          , Rr          , Rr          , Rd          , 8 Rp^Vhc    , Rd          , Rd          , Rd          , 5 Rp^Vhc    , Rd          , Rr          , Rr          , Ch          , Rr          , Rr          , Gg          , Gg          
Gg          , Gg          , Rr          , Rr          , Rr          , Rp^Vhc      , Rd          , Rd          , Rd          , Rp^Vhc      , Rd          , Rd          , Rp^Vhc      , Rr          , Rr          , Rr          , Ch          , Rr          , Gg          , Gg          
Gg          , Rr          , Ch          , Ch          , Rr          , Rd          , Rd          , Rp^Vhc      , Rd          , Rd          , 4 Rp^Vhc    , Rd          , Rd          , Rd          , Rr          , Ch          , Rr          , Rr          , Gg          , Gs^Fds      
Gg          , Rr          , Rr          , Rr          , Rr          , Rp^Vhc      , Rd          , Rd          , 9 Rp^Vhc    , Rd          , Rd          , Rd          , Rd          , 6 Rp^Vhc    , Rr          , Rr          , Ch          , Rr          , Gg          , Hh          
Gg          , Rr          , Ch          , Ch          , Rr          , Rd          , Rp^Vhc      , Rd          , Rd          , Rd          , Rd          , 7 Rp^Vhc    , Rd          , Rr          , Rr          , Ch          , Rr          , Rr          , Gg          , Gs^Fds      
Gg          , Rr          , Rr          , Rr          , Ch          , Rr          , Rr          , Rd          , Rr          , Rp^Vhc      , Rr          , Rd          , Rr          , Rd          , Rd          , Rr          , Rr          , Gg          , Re^Gvs      , Gg          
Re^Gvs      , Gg          , Rr          , Ch          , Rr          , Rr          , Ch          , Rr          , Rr          , Rr          , Ch          , Rr          , Ch          , Ch          , Rr          , 2 Kh        , Rr          , Gg          , Gs^Fds      , Gg          
Gg          , Ggf         , Gg          , Rr          , Gg          , Rr          , Ch          , Ch          , Rr          , Ch          , Rr          , Rr          , Rr          , Rr          , Gg          , Rr          , Gg          , Gg          , Re^Gvs      , Gg          
Gs^Fds      , Hh          , Gs^Fds      , Ggf         , Ggf         , Rr          , Rr          , Rr          , Gg          , Rr          , Ggf         , Gg          , Gg          , Gg          , Gs^Fds      , Gs^Fds      , Re^Gvs      , Ggf         , Gg          , Gg          
Gg          , Gs^Fds      , Gg          , Gg          , Gg          , Gg          , Gg          , Gg          , Gg          , Gg          , Gg          , Ggf         , Gg          , Gs^Fds      , Hh          , Gs^Fds      , Gg          , Ggf         , Gg          , Gg          
