border_size=1
usage=map

Xuc         , Xuc         , Xuc         , Xuc         , Xuc         , Xuc         , Xuc         , Xuc         , Xuc         , Xuc         , Xuc         , Xuc         , Xuc         , Xuc         , Xuc         , Xuc         , Xuc         , Xuc         , Xuc         , Xuc         , Xuc         , Xuc         , Xuc         , Xuc         , Xuc         , Xuc         , Xuc         , Xuc         , Xuc         , Xuc         , Xuc         , Xuc         , Xuc         , Xuc         , Xuc         , Xuc         , Xuc         , Xuc         , Xuc         , Xuc         , Xuc         , Xuc         , Xuc         , Xuc         , Xuc         
Xuc         , Xuc         , Uh          , Xuc         , Rb          , Rb          , Rb          , Xuc         , Qxu         , Qxu         , Uu^Vud      , Xuc         , Xuc         , Xuc         , Xuc         , Xuc         , Xuc         , Xuc         , Xuc         , Xuc         , Xuc         , Xuc         , Xuc         , Xuc         , Xuc         , Xuc         , Xuc         , Xuc         , Xuc         , Xuc         , Xuc         , Xuc         , Xuc         , Xuc         , Uue         , Xuc         , Cud         , Cud         , 4 Kud       , Cud         , Cud         , Xuc         , Xuc         , Xuc         , Xuc         
Xuc         , Xuc         , Uu^Vud      , Rb          , Uu          , Uu          , Qxu         , Qxu^Bs\     , Cud         , Cud         , Xuc         , Xuc         , Xuc         , Xuc         , Xuc         , Xuc         , Xuc         , Xuc         , Xuc         , Xuc         , Xuc         , Xuc         , Xuc         , Xuc         , Xuc         , Xuc         , Xuc         , Xuc         , Xuc         , Xuc         , Uh          , Uu^Vud      , Rb          , Uue         , Xu          , Rb          , Xu          , Uu^Vud      , Xu          , Uu^Vud      , Uue         , Uu^Uf       , Xuc         , Xuc         , Xuc         
Xuc         , Xuc         , Uh          , Rb          , Uu          , Qxu         , Qxu         , 7 Kud       , Xuc         , Xuc         , Xuc         , Xuc         , Xuc         , Xuc         , Xuc         , Xuc         , Uh          , Uu          , Uu          , Uu^Vud      , Rb          , Uu          , Uu^Emf      , Xuc         , Xuc         , Xuc         , Xuc         , Xuc         , Xuc         , Xuc         , Rb          , Rb          , Uue         , Rb          , Rb          , Rb          , Rb          , Cud         , Cud         , Cud         , Xuc         , Uue         , Uue         , Xuc         , Xuc         
Xuc         , Uh          , Uh^Emf      , Rb          , Rb          , Uu          , Qxu^Bs/     , Cud         , Xuc         , Xuc         , Xuc         , Xuc         , Xuc         , Xuc         , Uu^Emf      , Uh          , Uh          , Wwf         , Uu          , Rb          , Uu          , Rb          , Uh          , Uu          , Rb          , Uh^Emf      , Xuc         , Xuc         , Xuc         , Uu^Vud      , Rb          , Uue         , Xuc         , Uue         , Rb          , Uu^Uf       , Rb          , Xuc         , Uue         , Uu^Uf       , Uue         , Uue         , Uh          , Uu^Vud      , Xuc         
Xuc         , Uh          , Rb          , Rb          , Uu^Vu       , Rb          , Qxu^Bs\     , Cud         , Xuc         , Xuc         , Xuc         , Xuc         , Rb          , Uu          , Chw         , Uu          , Wog         , Wwf         , Uu          , Uu          , Wwg         , Uu          , Uu          , Rb          , Rb          , Uh          , Xuc         , Xuc         , Uue         , Uue         , Rb          , Rb          , Uue         , Xuc         , Uh          , Rb          , Rb          , Uue         , Uue         , Uue         , Uue         , Uh          , Uh^Emf      , Uh^Emf      , Xuc         
Xuc         , Uu^Vu       , Rb          , Rb          , Qxu         , Qxu         , Qxu         , Uu^Vud      , Xuc         , Xuc         , Xuc         , Rb          , Uu          , Uu          , Khw         , Ww^Vm       , 6 Khw       , Wwf         , Wwg         , Wwrg        , Uu^Vu       , Wwf         , Rb          , Rb          , Uu          , Xuc         , Xuc         , Xuc         , Rb          , Rb          , Uue         , Uue         , Xuc         , Xuc         , Rb          , Rb          , Uue         , Rb          , Uue         , Uu^Vu       , Xuc         , Uue         , Uue         , Uu^Uf       , Xuc         
Xuc         , Uu          , Rb          , Uu^Vu       , Rb          , Uu^Vu       , Qxu^Bs/     , Cud         , Xuc         , Xuc         , Rb          , Uu          , Wog         , Wog         , Chw         , Ww^Vm       , Chw         , Chw         , Wwf         , Wwf         , Wwf         , Wwf         , Rb          , Uu          , Xuc         , Xuc         , Xuc         , Uh          , Uu^Uf       , Rb          , Rb          , Xuc         , Rb          , Uh          , Rb          , Uue         , Xuc         , Rb          , Uue         , Xuc         , Uh          , Uue         , Uue         , Xuc         , Xuc         
Xuc         , Uu          , Rb          , Rb          , Uu^Emf      , Rb          , Qxu         , Xuc         , Xuc         , Uh          , Rb          , Uu          , Ur          , Chw         , Ww^Vm       , Wwf         , Ww^Vm       , Chw         , Wwf         , Wwrg        , Wog         , Uu          , Rb          , Rb          , Xuc         , Xuc         , Uu^Vud      , Uh          , Uu          , Uu          , Rb          , Rb          , Uh          , Rb          , Uh          , Uue         , Rb          , Rb          , Xuc         , Xuc         , Xuc         , Uh          , Uue         , Xuc         , Xuc         
Xuc         , Rb          , Uu          , Qxu         , Qxu         , Qxu^Bs|     , Rb          , Xuc         , Xuc         , Uh^Emf      , Wwrg        , Wog         , Wwf         , Wwrg        , Uu          , Chw         , Uu          , Wwrg        , Wwf         , Wwf         , Wog         , Uu          , Uu          , Rb          , Xuc         , Xuc         , Xuc         , Xuc         , Uh          , Rb          , Rb          , Rb          , Xuc         , Uh          , Xuc         , Uu^Vu       , Rb          , Xuc         , Uue         , Uh          , Uh          , Uu^Uf       , Uue         , Xuc         , Xuc         
Xuc         , Rb          , Uu          , Qxu         , Rb          , Rb          , Xuc         , Xuc         , Xuc         , Rb          , Rb          , Wog         , Wwf         , Wwf         , Wwf         , Chw         , Wwf         , Wwf         , Wog         , Uu          , Wwrg        , Wwg         , Wwg         , Rb          , Uh^Emf      , Xuc         , Xuc         , Xuc         , Uu^Emf      , Rb          , Rb          , Uue         , Uue         , Xuc         , Uue         , Xuc         , Uue         , Uue         , Rb          , Uue         , Rb          , Uue         , Xuc         , Xuc         , Xuc         
Xuc         , Rb          , Rb          , Uu          , Uu^Emf      , Rb          , Xuc         , Xuc         , Xuc         , Rb          , Rb          , Wog         , Wwf         , Wwg         , Qxu         , Wwf         , Wog         , Wwf         , Wwf         , Wwf         , Chw         , Uu          , Wwg         , Rb          , Uu^Emf      , Xuc         , Xuc         , Xuc         , Xuc         , Uh          , Xuc         , Uue         , Uue         , Uue         , Uue         , Rb          , Uue         , Uue         , Uu^Vu       , Uue         , Uue         , Xuc         , Xuc         , Xuc         , Xuc         
Xuc         , Uu          , Rb          , Uu          , Qxu         , Rb          , Xuc         , Xuc         , Xuc         , Xuc         , Rb          , Wog         , Wwf         , Qxu         , Qxu         , Wog         , Wwg         , Wwg         , Wwf         , Wwf         , Wwf         , Uu          , Wwg         , Rb          , Uh          , Xuc         , Xuc         , Xuc         , Xuc         , Xuc         , Xuc         , Xuc         , Uue         , Uue         , Rb          , Uue         , Xuc         , Rb          , Rb          , Uue         , Rb          , Uue         , Xuc         , Xuc         , Xuc         
Xuc         , Rb          , Uu          , Uu          , Qxu         , Uu          , Rb          , Xuc         , Xuc         , Xuc         , Rb          , Uu          , Wwrg        , Wwg         , Wwg         , Wwg         , Wwg         , Ww^Vm       , Rb          , Rb          , Wwrg        , Wwf         , Rb          , Rb          , Uh          , Uh^Emf      , Uu          , Xuc         , Wwg         , Xuc         , Xuc         , Xuc         , Uu^Vud      , Rb          , Rb          , Uue         , Xuc         , Uue         , Rb          , Uue         , Xuc         , Rb          , Uue         , Xuc         , Xuc         
Xuc         , Qxu^Bs|     , Qxu         , Qxu         , Uu^Vud      , Uu          , Rb          , Xuc         , Rb          , Xuc         , Xuc         , Rb          , Uu          , Wwf         , Uu          , Uu          , Wwg         , Wwg         , Rb          , Uu          , Wwg         , Wwf         , Wwg         , Uu          , Chw         , Uu          , Wog         , Wog         , Ww^Vm       , Wog         , Xuc         , Xuc         , Xuc         , Rb          , Rb          , Uue         , Xuc         , Uue         , Uh          , Uue         , Uu^Uf       , Xuc         , Rb          , Uh          , Xuc         
Xuc         , Rb          , Rb          , Uu          , Uu          , Rb          , Qxu         , Rb          , Rb          , Xuc         , Xuc         , Rb          , Rb          , Uu          , Uu          , Wog         , Wog         , Wwrg        , Rb          , Wwg         , Uu          , Wwf         , Rb          , Uh          , Wwg         , Wwg         , Wwg         , Wog         , Wwrg        , Wog         , Uu          , Xuc         , Xuc         , Uu^Uf       , Rb          , Uue         , Rb          , Xuc         , Uue         , Rb          , Uue         , Xuc         , Uue         , Uh          , Xuc         
Xuc         , Uu          , Uu          , Rb          , Uu          , Uh          , Qxu         , Qxu         , Uu^Vud      , Rb          , Xuc         , Uu^Vud      , Uu          , Rb          , Chw         , Wwg         , Wwg         , Uu          , Wwf         , Rb          , Wwg         , Wog         , Wwg         , Wwg         , Wog         , Rb          , Uu          , Wwg         , Wwg         , Wog         , Uu          , Xuc         , Xuc         , Xuc         , Xuc         , Rb          , Uue         , Rb          , Uue         , Rb          , Xuc         , Xuc         , Uu^Vud      , Rb          , Xuc         
Xuc         , Uu          , Qxu         , Rb          , Qxu         , Qxu         , Qxu         , Uh          , Uu          , Rb          , Rb          , Xuc         , Uu          , Rb          , Rb          , Wwg         , Wwg         , Wwg         , Rb          , Wwf         , Rb          , Uu          , Rb          , Wog         , Rb          , Rb          , Wwg         , Wwg         , Wwg         , Rb          , Wog         , Uh          , Xuc         , Xuc         , Xuc         , Uue         , Uue         , Rb          , Uue         , Uue         , Rb          , Rb          , Rb          , Xuc         , Xuc         
Xuc         , Uu          , Rb          , Rb          , Rb          , Uu          , Rb          , Rb          , Rb          , Rb          , Xuc         , Xuc         , Xuc         , Rb          , Rb          , Wwg         , Rb          , Wwf         , Wwf         , Wwf         , Wwg         , Wwf         , Wwf         , Wog         , Wwg         , Wwg         , Wwrg        , Ww^Vm       , Wwf         , Wwf         , Wog         , Uu          , Uu          , Xuc         , Xuc         , Xuc         , Uu^Vu       , Rb          , Uue         , Uue         , Rb          , Rb          , Rb          , Xuc         , Xuc         
Xuc         , Rb          , Uu          , Uu          , Qxu         , Rb          , Qxu         , Uu          , Uu          , Rb          , Cud         , Xuc         , Xuc         , Xuc         , Wwf         , Wwf         , Wog         , Wwf         , Rb          , Wwg         , Rb          , Wwf         , Wwg         , Wwg         , Wwf         , Rb          , Wwf         , Wwg^Bw\r    , Wwf         , Rb          , Uh          , Uu          , Xuc         , Xuc         , Xuc         , Xuc         , Xuc         , Rb          , Uue         , Rb          , Rb          , Uue         , Rb          , Rb          , Xuc         
Xuc         , Rb          , Uu          , Uu^Vu       , Qxu         , Qxu^Bs|     , Qxu         , Uu          , Uu          , Uu^Vu       , Cud         , 5 Kud       , Xuc         , Xuc         , Wwf         , Uu          , Wwf         , Uu^Vu       , Wog         , Wwg         , Wog         , Wwg         , Wwrg        , Wwg         , Wwg         , Wwg         , Wog         , Wwg^Bw|r    , Ss          , Rb          , Uu          , Uu^Vu       , Uh          , Xuc         , Xuc         , Xuc         , Xuc         , Xuc         , Cud         , Rb          , Uue         , Uue         , Cud         , Rb          , Xuc         
Xuc         , Rb          , Qxu^Bs\     , Qxu         , Uu          , Qxu^Bs|     , Qxu         , Uu          , Xuc         , Uh          , Xuc         , Uu^Vud      , Xuc         , Wog         , Wwf         , Ur          , Ur          , Ur          , Ur          , Wog         , Wwg         , Wwg         , Uu          , Uu          , Uu          , Wog         , Wwrg        , Ss^Vhs      , Ss^Bw\r     , Uu^Uf       , Uh          , Uh          , Xuc         , Rb          , Xuc         , Xuc         , Xuc         , Xuc         , 3 Kud       , Uue         , Uu^Vud      , Uue         , Kud         , Uh          , Xuc         
Xuc         , Qxu         , Uu          , Rb          , Rb          , Rb          , Xuc         , Xuc         , Xuc         , Xuc         , Xuc         , Xuc         , Xuc         , Wwg         , Ur          , Xuc         , Uu          , Wwf         , Wwf         , Wwf         , Wwf         , Chw         , Uu          , Uu          , Wwf         , Wog         , Ur          , Chs         , Uu          , Uh          , Uh          , Rb          , Uh          , Uh          , Uh          , Xuc         , Xuc         , Xuc         , Qxu         , Uh          , Cud         , Cud         , Uu^Vu       , Uu^Uf       , Xuc         
Xuc         , Uu^Emf      , Qxu         , Rb          , Qxu         , Rb          , Qxu^Bs\     , Xuc         , Xuc         , Xuc         , Xuc         , Xuc         , Wog         , Wwg         , Wwf         , Wwf         , Wwf         , Wwf         , Ww^Vm       , Wog         , Wwf         , Xuc         , Xuc         , Xuc         , Wwg         , Ur          , Xuc         , Uu          , Xuc         , Xuc         , Uh          , Xuc         , Rb          , Xuc         , Uh          , Xuc         , Xuc         , Xuc         , Qxu         , Uu^Uf       , Cud         , Uu^Vud      , Uu^Vu       , Uh          , Xuc         
Xuc         , Uu^Vu       , Rb          , Rb          , Qxu         , Qxu^Bs|     , Uu^Vud      , Uu          , Xuc         , Xuc         , Xuc         , Xuc         , Wwg         , Ur          , Wwf         , Wwf         , Wwf         , Wog         , Wog         , Wog         , Wwf         , Wwf         , Uu          , Rb          , Chw         , Xuc         , Uu          , Xuc         , Wwf         , Rb          , Rb          , Uu^Vud      , Rb          , Xuc         , Rb          , Xuc         , Wwf         , Wwf         , 1 Kud       , Cud         , Uu^Vud      , Cud         , 2 Kud       , Uh          , Xuc         
Xuc         , Uh          , Qxu         , Qxu^Bs|     , Qxu         , Rb          , Uu          , Uh^Emf      , Qxu         , Qxu         , Qxu         , Qxu         , Wwf         , Wwf         , Ur          , Wwf         , Wwf         , Wwf         , Wwf         , Uu          , Ur          , Uu          , Rb          , Chw         , Rb          , Wwg         , Wwg         , Wwg         , Wwg         , Wwg         , Wwg         , Rb          , Wwg         , Wwf         , Wwf         , Rb          , Wwf         , Cud         , Cud         , Uu^Vud      , Uu^Vu       , Uu^Vu       , Cud         , Uh          , Xuc         
Xuc         , Rb          , Rb          , Rb          , Qxu         , Uu          , Qxu         , Qxu^Bs\     , Rb          , Uu^Vu       , Rb          , Wwf         , Wwf         , Wwf         , Wwf         , Uu          , Ur          , Ur          , Wwf         , Wwf         , Wwf         , Wwf         , Wwf         , Wwf         , Chw         , Wwf         , Rb          , Wwg         , Ww^Vm       , Uu          , Rb          , Wwg         , Rb          , Wwg         , Wwg         , Wwg         , Rb          , Uu          , Qxu         , Xuc         , Xuc         , Uu^Vud      , Cud         , Wog         , Xuc         
Xuc         , Rb          , Rb          , Qxu         , Qxu         , Qxu^Bs|     , Qxu         , Qxu         , Uh          , Rb          , Rb          , Qxu         , Wwg         , Uh          , Uu          , Ur          , Ur          , Wwf         , Ur          , Ur          , Uu          , Rb          , Uu          , Khw         , Uu          , Wwf         , Wwf         , Uu          , Wwf         , Rb          , Wwf         , Rb          , Wwf         , Rb          , Wwf         , Rb          , Wwg         , Uu^Vu       , Ur          , Qxu         , Qxu^Bs/     , Xuc         , Cud         , Wog         , Xuc         
Xuc         , Wog         , Uu^Vud      , Rb          , Qxu^Bs\     , Rb          , Rb          , Rb          , Rb          , Rb          , Qxu^Bs\     , Qxu         , Wwg         , Ur          , Ur          , Ur          , Uu^Vud      , Uu          , Xuc         , Uu          , Xuc         , Rb          , Xuc         , Uu          , Rb          , Uu^Vu       , Rb          , Wwf         , Xuc         , Wwf         , Xuc         , Wwf         , Wwf         , Wwf         , Xuc         , Wwg         , Xuc         , Wwf         , Wwf         , Ur          , Qxu         , Ur          , Qxu         , Wog         , Wog         
Xuc         , Wog         , Qxu         , Rb          , Qxu         , Rb          , Qxu         , Uh          , Qxu         , Rb          , Qxu         , Wwf         , Wwf         , Ur          , Wwf         , Rb          , Rb          , Uue         , Uue         , Xuc         , Uue         , Uue         , Uue         , Xuc         , Rb          , Uue         , Uue         , Xuc         , Xuc         , Xuc         , Xuc         , Xuc         , Xuc         , Xuc         , Xuc         , Xuc         , Xuc         , Xuc         , Wog         , Wwf         , Wwg         , Qxu         , Wog         , Wog         , Wwg         
Xuc         , Wog         , Wog         , Wog         , Wog         , Qxu         , Wwg         , Wwf         , Wwf         , Qxu         , Wwf         , Wwf         , Wwg         , Wwg         , Wwg         , Wwf         , Rb          , Uue         , Uue         , Uue         , Uue         , Xuc         , Uue         , Xuc         , Uue         , Rb          , Uue         , Uue         , Rb          , Xuc         , Xuc         , Xuc         , Xuc         , Xuc         , Xuc         , Xuc         , Xuc         , Wog         , Xuc         , Xuc         , Xuc         , Wwg         , Wog         , Wwr         , Wog         
Xuc         , Wog         , Wog         , Xuc         , Xuc         , Wog         , Ww^Vm       , Wwg         , Wwg         , Wwf         , Wwg         , Xuc         , Xuc         , Wog         , Wwg         , Wwf         , Wwf         , Rb          , Xuc         , Xuc         , Xuc         , Uue         , Uue         , Uue         , Xuc         , Rb          , Rb          , Rb          , Rb          , Xuc         , Wwf         , Xuc         , Wwg         , Wwg         , Wwg         , Xuc         , Wog         , Wog         , Xuc         , Xuc         , Wwr         , Ww^Ewl      , Wog         , Wwg         , Wog         
Xuc         , Xuc         , Wog         , Wog         , Xuc         , Xuc         , Wog         , Wog         , Xuc         , Wwg         , Xuc         , Xuc         , Xuc         , Wog         , Wwg         , Wwf         , Wwf         , Rb          , Xuc         , Xuc         , Xuc         , Xuc         , Xuc         , Xuc         , Xuc         , Rb          , Xuc         , Xuc         , Rb          , Uue         , Wwf         , Wwg         , Wwg         , Ww^Vm       , Wwg         , Xuc         , Wog         , Xuc         , Wog         , Wog         , Ww^Vm       , Wog         , Wog         , Wwr         , Wog         
Xuc         , Xuc         , Xuc         , Wog         , Wog         , Xuc         , Wog         , Wog         , Xuc         , Xuc         , Wog         , Xuc         , Xuc         , Xuc         , Wog         , Wwg         , Wog         , Uu^Vud      , Wwf         , Wwf         , Wwf         , Wwf         , Wwf         , Xuc         , Wwf         , Rb          , Xuc         , Uu^Vu       , Rb          , Uue         , Wwf         , Wwg         , Xuc         , Wog         , Wog         , Wog         , Wog         , Wog         , Xuc         , Wog         , Wog         , Wog         , Wog         , Wog         , Wog         
Xuc         , Xuc         , Xuc         , Wwrg        , Wwrg        , Wog         , Wog         , Wog         , Wog         , Wwrg        , Wog         , Xuc         , Xuc         , Xuc         , Wog         , Xuc         , Wog         , Wwg         , Wwg         , Wwg         , Wwg         , Ww^Vm       , Wwg         , Wwf         , Wwg         , Wwf         , Wwf         , Wwf         , Wwf         , Wwf         , Xuc         , Wwg         , Xuc         , Wwg         , Xuc         , Wwg         , Wwg         , Wwg         , Xuc         , Wog         , Wog         , Wog         , Ww^Vm       , Wog         , Wog         
Xuc         , Xuc         , Xuc         , Xuc         , Xuc         , Wog         , Xuc         , Xuc         , Xuc         , Wog         , Wog         , Wog         , Xuc         , Wog         , Wog         , Xuc         , Xuc         , Wog         , Xuc         , Wog         , Xuc         , Wog         , Wog         , Wwg         , Uue         , Wwg         , Uue         , Wwg         , Wwg         , Uue         , Xuc         , Xuc         , Xuc         , Xuc         , Xuc         , Xuc         , Xuc         , Wwg         , Wwrg        , Xuc         , Xuc         , Wog         , Wog         , Wog         , Xuc         
Xuc         , Xuc         , Xuc         , Xuc         , Xuc         , Xuc         , Xuc         , Xuc         , Xuc         , Wog         , Xuc         , Wog         , Wog         , Wog         , Wog         , Wwrg        , Xuc         , Xuc         , Xuc         , Xuc         , Xuc         , Xuc         , Wog         , Xuc         , Xuc         , Xuc         , Xuc         , Xuc         , Wog         , Xuc         , Xuc         , Xuc         , Xuc         , Xuc         , Xuc         , Xuc         , Wog         , Wog         , Xuc         , Xuc         , Wog         , Wog         , Xuc         , Xuc         , Xuc         
Xuc         , Xuc         , Xuc         , Xuc         , Xuc         , Xuc         , Xuc         , Xuc         , Xuc         , Xuc         , Xuc         , Xuc         , Wwrg        , Wwrg        , Xuc         , Wog         , Wog         , Xuc         , Wwrg        , Xuc         , Wog         , Xuc         , Wog         , Wog         , Wog         , Xuc         , Xuc         , Xuc         , Xuc         , Wog         , Wog         , Wwrg        , Wog         , Wog         , Wog         , Wog         , Xuc         , Wog         , Wog         , Wog         , Xuc         , Xuc         , Xuc         , Xuc         , Xuc         
Xuc         , Xuc         , Xuc         , Xuc         , Xuc         , Xuc         , Xuc         , Xuc         , Xuc         , Xuc         , Xuc         , Xuc         , Xuc         , Xuc         , Xuc         , Wog         , Wog         , Wog         , Wog         , Wog         , Xuc         , Wog         , Xuc         , Wog         , Wog         , Wog         , Wog         , Wwrg        , Wog         , Wog         , Wog         , Wog         , Wog         , Xuc         , Wog         , Wog         , Wog         , Wog         , Xuc         , Xuc         , Xuc         , Xuc         , Xuc         , Xuc         , Xuc         
Xuc         , Xuc         , Xuc         , Xuc         , Xuc         , Xuc         , Xuc         , Xuc         , Xuc         , Xuc         , Xuc         , Xuc         , Xuc         , Xuc         , Xuc         , Xuc         , Xuc         , Xuc         , Xuc         , Wog         , Xuc         , Xuc         , Xuc         , Xuc         , Xuc         , Xuc         , Xuc         , Wog         , Xuc         , Wog         , Xuc         , Xuc         , Xuc         , Wog         , Xuc         , Xuc         , Xuc         , Xuc         , Xuc         , Xuc         , Xuc         , Xuc         , Xuc         , Xuc         , Xuc         
Xuc         , Xuc         , Xuc         , Xuc         , Xuc         , Xuc         , Xuc         , Xuc         , Xuc         , Xuc         , Xuc         , Xuc         , Xuc         , Xuc         , Xuc         , Xuc         , Xuc         , Xuc         , Xuc         , Xuc         , Xuc         , Xuc         , Xuc         , Xuc         , Xuc         , Xuc         , Xuc         , Xuc         , Xuc         , Xuc         , Xuc         , Xuc         , Xuc         , Xuc         , Xuc         , Xuc         , Xuc         , Xuc         , Xuc         , Xuc         , Xuc         , Xuc         , Xuc         , Xuc         , Xuc         
Xuc         , Xuc         , Xuc         , Xuc         , Xuc         , Xuc         , Xuc         , Xuc         , Xuc         , Xuc         , Xuc         , Xuc         , Xuc         , Xuc         , Xuc         , Xuc         , Xuc         , Xuc         , Xuc         , Xuc         , Xuc         , Xuc         , Xuc         , Xuc         , Xuc         , Xuc         , Xuc         , Xuc         , Xuc         , Xuc         , Xuc         , Xuc         , Xuc         , Xuc         , Xuc         , Xuc         , Xuc         , Xuc         , Xuc         , Xuc         , Xuc         , Xuc         , Xuc         , Xuc         , Xuc         
