border_size=1
usage=map

Gg          , Gg          , Ww          , Gg          , Gg          , Gs^Fds      , Hh          , Gg          , Ww          , Gg          , Gg          , Gg          , Ww          , Ww          , Gg          , Gg          , Gg          , Gg          , Gg          , Gg          , Gg          , Gg          , Hh^Fds      , Gg          , Gg          , Gg          , Hh          , Gg          , Gg          , Ds          , Ww          , Ww          , Ww          , Ds          , Gg          , Gg          , Ww          , Ww          , Gg          , Gg          , Ww          , Ww          
Ggf         , Hh          , Gs^Fds      , Ww          , Gg          , Gs^Fds      , Gg          , Ds          , Ww          , Ww          , Gs^Fds      , Gs^Fds      , Ds          , Ww          , Gg          , Hh          , Gs^Fds      , Gs^Fds      , Gg          , Gg          , Gg          , Hh          , Hh          , Gg          , Gg          , Gs^Fds      , Gs^Fds      , Hh^Fds      , Gg          , Ds          , Ds          , Ww          , Gg          , Gg          , Gs^Fds      , Gg          , Gg          , Gg          , Gg          , Ww          , Gg          , Gg          
Ggf         , Gs^Fds      , Gg          , Gg          , Gg          , Gg          , Gg          , Ww          , Wwf         , Wwf         , Hh          , Gs^Fds      , Re^Gvs      , Ww          , Gg          , Gs^Fds      , Gg          , Gg          , Wwf         , Ww          , Gg          , Hh          , Gs^Fds      , Gg          , Gg          , Gg          , Gg          , Gg          , Gg          , Gg          , Gg          , Gg          , Gg          , Hh          , Hh          , Hh          , Gg          , Gg          , Gs^Fds      , Gg          , Gg          , Ww          
Ggf         , Ww          , Ww          , Gg          , Rr          , Rr          , Rr          , Gg          , Gg          , Gg          , Re^Gvs      , Re^Gvs      , Gg^Wm       , Re^Gvs      , Re^Gvs      , Gg          , Gg          , Gg          , Gg          , Gg          , Gg          , Gg          , Gg          , Gg          , Rr          , Gg          , Rr          , Rr          , Rr          , Gg          , Gg          , Gg          , Ds          , Gg          , Gg          , Gg          , Gg          , Hh^Fds      , Hh          , Gg          , Gg          , Gg          
Ggf         , Gg          , Gg          , Gg          , Rr          , Ch^Dr       , Ch          , Rr          , Rr          , Rr          , Rr          , Re^Gvs      , Re^Gvs      , Re^Gvs      , Rr          , Gg          , Rr          , Rr          , Rr          , Rr          , Rr          , Gg          , Rr          , Rr^Dr       , Ch          , Rr^Dr       , Rr          , Ch          , Ch^Dr       , Rr          , Wwf         , Ww          , Ww          , Gg          , Gg          , Gg^Fet      , Gg          , Hh^Fds      , Gs^Fds      , Gg          , Gg          , Ds          
Ggf         , Gs^Fds      , Ggf         , Rr          , Rr^Dr       , Rr          , Rr          , Rr          , Rr^Dr       , Ch          , Rr          , Rr          , Rp^Vhc      , Rr          , Ch          , Rr          , Rr^Dr       , Ch          , Rr          , Ch^Dr       , Ch          , Rr          , Rr          , Ch          , Rr          , Rr          , Rp^Vhc      , Rr          , Rr          , Rr          , Wwf         , Ww          , Ww          , Gg          , Gg          , Gg          , Gs^Fds      , Gg          , Gg          , Gg          , Ww          , Ww          
Wwf         , Ggf         , Wwf         , Rr          , Rr          , Ch          , Rr          , Rr          , Rd          , Rd          , Rd          , Rd          , Rd          , Rr          , Rr          , Rr          , Rp^Vhc      , Rr          , Rd          , Rr          , Rr          , Rr          , Rd          , Rr          , Rd          , Rd          , Rd          , Rr          , Ch          , Rr^Dr       , Rr          , Wwf         , Gg          , Gg          , Gg          , Gs^Fds      , Hh          , Gs^Fds      , Gg          , Gg          , Ww          , Ww          
Ww          , Wwf         , Wwf         , Wwf         , Chw         , Rr          , Rp^Vhc      , Rd          , Ch          , Rp^Vhc      , Rr          , Ch          , Rp^Vhc      , Rd          , Rd          , Rd          , Rd          , Rd          , Rr          , Rd          , Rd          , Rd          , Rp^Vhc      , Rd          , Ch          , Ch          , Rd          , Rr          , Rr          , Ch^Dr       , Rr          , Wwf         , Gg          , Gg          , Gg          , Gg^Fet      , Re^Gvs      , Hh^Fds      , Gg          , Gg          , Gg          , Ww          
Wo          , Ww          , Ww          , Wwf^Bw/     , Wwf^Bw/     , Ch          , Ch          , Rr          , Rr          , Rr          , Rr          , Rr          , Rr          , Rr^Dr       , Rr          , Rp^Vhc      , Rr          , Rr          , Ch          , 5 Kh        , Rr          , Rd          , Rd          , Rr^Dr       , Rd          , Rp^Vhc      , Rd          , Rr          , Rr          , Rr          , Ch          , Wwf         , Wwf         , Gg          , Gg          , Re^Gvs      , Gg^Vh       , Re^Gvs      , Gg          , Gg^Fet      , Re^Gvs      , Gg          
Wo          , Wo          , Ww          , Wwf^Bw/     , Wwf^Bw/     , 6 Kh        , Ch          , Rr          , Ggf         , Ggf         , Chw         , Ch          , Ggf         , Rr          , Chw         , Ch          , Ggf         , Rr^Dr       , Chw         , Rp^Vhc      , Ch          , Rr          , Rr          , Rr^Dr       , Rr          , Rd          , Rp^Vhc      , Ch          , Rr          , Rr^Dr       , 4 Kh        , Ch          , Ds          , Gg          , Gg          , Re^Gvs      , Re^Gvs      , Re          , Re          , Gg          , Gg          , Re^Gvs      
Ww          , Ww^Vm       , Ww          , Ww          , Wwf         , Ggf         , Wwf         , Chw         , Ww^Bw\      , Wwf^Bw/     , Ww          , Wwr         , Ww          , Wwf         , Wwf         , Ww^Bw\      , Ww^Bw/      , Wwf^Bw/     , Wwf^Bw\     , Chw         , Chw         , Ds          , Ggf         , Rr          , Chw         , Rr          , Ggf         , Ch          , Rr          , Rr          , Chw         , Chw         , Wwf         , Gg          , Ww          , Gg          , Gg          , Gg          , Gg          , Re          , Gg^Fet      , Re^Gvs      
Ww          , Ww          , Wwf         , Wwf         , Wwf         , Wwf         , Wwf         , Ww          , Ww          , Ww          , Ww          , Ww          , Ww          , Wwr         , Ww          , Ww          , Ww          , Ww          , Ww          , Wwf^Bw/     , Ww          , Ww^Bw\      , Ww^Bw/      , Wwf^Bw/     , Wwf^Bw\     , Chw         , Ww^Bw\      , Ggf         , Chw         , Chw         , Wwf^Bw/     , Wwf^Bw/     , Wwr         , Ww          , Ww          , Ww          , Gg          , Gg^Wm       , Gg          , Re          , Re          , Gg          
Wwf         , Wwf         , Gs          , Wwf         , Wwf         , Wwf         , Gs          , Ww          , Gs          , Wwr         , Wwf         , Wwf         , Wwf         , Wwf         , Wwf         , Ww          , Gs          , Ww          , Ww          , Ww          , Wwf         , Ww          , Ww          , Ww          , Wwf         , Ww^Bw/      , Ww          , Ww^Bw/      , Wwf         , Wwf^Bw\     , Wwr         , Wwf^Bw\     , Ww          , Ww          , Wwr         , Ww          , Ww          , Gg          , Re^Gvs      , Gg^Vh       , Re          , Gg          
Xu          , Wwf         , Wwf         , Gs          , Gs          , Gs          , Gs          , Gs          , Gs^Vht      , Gs          , Gs          , Gs          , Gs          , Gs          , Gs          , Gs          , Gs          , Gs          , Gs          , Wwf         , Gs          , Wwf         , Gs          , Wwf         , Gs          , Wwf         , Ww          , Ww          , Wwf         , Wwf         , Ww          , Ww          , Ww          , Ww^Vm       , Wwr         , Wwr         , Ww          , Gg          , Gg          , Gg          , Re          , Gg          
Xu          , Xu          , Xu          , Gs          , Xu          , Gs          , Gs          , Hh          , Gs^Ft       , Gs          , Gs          , Gs          , Gs          , Mm          , Hh^Fmw      , Gs          , Gs          , Gs          , Hh          , Gs          , Gs          , Gs          , Gs          , Gs          , Gs          , Gs          , Gs          , Wwf         , Gs          , Gs          , Ww          , Ww^Vm       , Wwr         , Ww          , Ww          , Ww^Vm       , Ww          , Ww          , Gg          , Re          , Gg          , Gg          
Cud         , Cud         , Cud         , Xu          , Cud         , Xu          , Xu          , Xu          , Xu          , Gs          , Xu          , Gs^Ft       , Gs          , Hh          , Gs          , Gs          , Gs^Ft       , Hh          , Mm          , Hh^Ft       , Mm          , Mm          , Mm          , Dd^Do       , Hh          , Hh          , Hh          , Gs          , Gs          , Gs          , Gs          , Ww          , Ww          , Ww          , Ww          , Wwr         , Ww          , Ww          , Gg          , Re          , Gg          , Re^Gvs      
Cud         , Cud         , Cud         , Cud         , Cud         , Cud         , Cud         , Cud         , Cud         , Xu          , Xu          , Mm          , Hh          , Gs          , Gs          , Gs          , Gs^Ft       , Mm          , Mm          , Mm          , Mm          , Mm          , Mm          , Hh^Ft       , Mm          , Mm          , Mm          , Mm          , Mm          , Hh          , Hh          , Gs          , Gs          , Gs          , Wwf         , Ww          , Wwf         , Gg          , Gg^Fet      , Re          , Re          , Gg          
Cud         , Cud         , Xu          , Cud         , Uu^Vud      , Uu          , Xu          , Cud         , Cud         , Cud         , Xu          , Xu          , Gs^Ft       , Gs          , Gs          , Gs          , Mm          , Hh          , Hh          , Mm          , Mm          , Mm          , Hh^Ft       , Mm          , Mm          , Mm          , Mm          , Mm          , Mm          , Mm          , Hh          , Gs          , Gs          , Gs          , Wwf         , Wwf         , Wwf         , Gg          , Gg          , Gg          , Re          , Gg          
Cud         , Cud         , Xu          , Cud         , Cud         , Uu          , Ur          , Ur          , Cud         , Xu          , Xu          , Mm^Xm       , Hh          , Gs          , Gs^Ft       , Gs          , Gs          , Mm          , Mm          , Hh          , Hh          , Hh          , Dd^Do       , Hh          , Hh          , Hh^Ft       , Hh          , Mm          , Hh          , Hh^Ft       , Gs          , Gs          , Gs          , Gs          , Wwf         , Wwf         , Ww          , Ww          , Re^Gvs      , Re          , Gg          , Gg          
Cud         , Cud         , Xu          , Xu          , Cud         , Uu^Uf       , Ur          , Ur          , Cud         , Cud         , Cud         , Xu          , Mm          , Gs          , Gs^Vht      , Hh          , Gs          , Gs          , Gs          , Gs^Ft       , Dd          , Dd          , Ds          , Dd          , Gs          , Gs          , Gs          , Hh          , Gs          , Gs          , Ds          , Ds          , Re^Vct      , Gs          , Chw         , Ww          , Ww^Vm       , Chw         , Re^Gvs      , Gg^Vh       , Gg          , Gg          
Cud         , Cud         , 9 Kud       , Cud         , Uh          , Xu          , Ur          , Xu          , Ur          , Cud         , Xu          , Xu          , Cud         , Gs          , Gs          , Gs          , Gs          , Gs          , Dd          , Hd          , Ds          , Ds          , Ds^Ft       , Dd          , Ds^Ft       , Dd          , Ds          , Gs          , Dd          , Gs          , Gs          , Ds          , Ds          , Gs          , Gs          , Chw         , 1 Kh        , Chw         , Ww          , Re^Gvs      , Gg^Fet      , Gg          
Cud         , Cud         , Cud         , Cud         , Uu          , Uu^Vud      , Ur          , Ur          , Ur          , Uu^Vud      , Xu          , Mm^Xm       , 7 Kud       , Cud         , Gs          , Gs          , Gs          , Dd          , Ds          , Ds^Ft       , Ds^Gvs      , Hd          , Dd^Vda      , Ds^Gvs      , Rd          , Md          , Ds^Gvs      , Hd          , Md          , Dd          , Gs          , Gs          , Rd          , Gs          , Rd          , Chw         , Ch          , Chw         , Ww          , Re^Gvs      , Re^Gvs      , Gg          
Cud         , Cud         , Xu          , Xu          , Uu^Uf       , Ur          , Qxu         , Ur          , Cud         , Cud         , Xu          , Mm^Xm       , Cud         , Cud         , Gs          , Gs          , Gs          , Dd          , Rd          , Dd^Do       , Rd          , Rd          , Rd          , Rd          , Ds^Ft       , Rd          , Rd          , Ds^Gvs      , Ds^Gvs      , Dd          , Rd          , Rd          , Dd^Vda      , Rd          , Rd          , Chw         , 2 Kh        , Chw         , Chw         , Gg^Vh       , Re^Gvs      , Gg          
Cud         , Cud         , Cud         , Cud         , Uh          , Ur          , Xu          , Xu          , Cud         , Cud         , Xu          , Xu          , Mm          , Gs          , Gs          , Gs          , Dd          , Rd          , Ds^Ft       , Rd          , Ds^Gvs      , Ds^Ft       , Dd^Dc       , Ds^Gvs      , Hd          , Ds^Gvs      , Ds          , Rd          , Rd          , Rd          , Gs          , Ds          , Ds          , Gs          , Gs          , Chw         , Chw         , Ww^Vm       , Ww          , Ww          , Ww          , Re^Gvs      
Cud         , Cud         , Cud         , Cud         , Cud         , Ur          , Ur          , Uu^Vud      , Ur          , Cud         , Xu          , Xu          , Hh          , Gs          , Gs          , Gs          , Dd          , Ds          , Md          , Hd          , Md          , Md          , Md          , Md          , Hd          , Md          , Ds^Ft       , Re^Vct      , Dd^Dc       , Ds          , Gs          , Gs          , Gs          , Gs          , Gs^Ft       , Gs          , Gs          , Ww          , Ww          , Ww          , Ww          , Ww          
Cud         , Cud         , Xu          , Xu          , Xu          , Uu^Uf       , Ur          , Ur          , Xu          , Cud         , Xu          , Mm^Xm       , Gs^Ft       , Gs          , Gs^Vht      , Gs          , Gs          , Dd          , Dd          , Dd          , Dd          , Dd          , Ds          , Dd          , Ds          , Ds          , Ds          , Ds^Ft       , Ds          , Ds          , Gs          , Ds          , Hh          , Ds          , Ds          , Hh          , Gs          , Gs          , Gs          , Ww          , Ww          , Ww          
Cud         , Cud         , Cud         , Xu          , Qxu         , Xu          , Ur          , Ur          , Ur          , Cud         , Xu          , Xu          , Hh          , Gs          , Gs^Ft       , Ds          , Gs          , Ds          , Hh          , Gs^Ft       , Dd          , Hd          , Mm          , Ds^Ft       , Gs^Ft       , Mm          , Mm          , Ds          , Gs          , Gs          , Gs          , Ds          , Ds          , Gs^Ft       , Ds          , Ds          , Gs          , Gs          , Hh          , Ww          , Ww          , Ww          
Cud         , Cud         , Cud         , Uh          , Uu^Vud      , Xu          , Ur          , Ur          , Cud         , Cud         , Xu          , Mm^Xm       , Hh          , Gs          , Ds          , Ds          , Gs          , Ds          , Gs          , Gs          , Dd          , Mm          , Mm          , Mm          , Mm          , Gs^Ft       , Mm          , Mm          , Mm          , Mm          , Mm          , Gs          , Re          , Re          , Re          , Gs          , Gs          , Gs          , Gs^Ft       , Gs^Ft       , Ww          , Ww          
Xu          , Xu          , Uu^Vud      , Ur          , Ur          , Ur          , Cud         , Cud         , Xu          , Xu          , Mm^Xm       , Gs^Ft       , Gs^Vht      , Gs          , Gs          , Gs          , Gs          , Gs          , Mm          , Mm          , Mm          , Dd          , Dd          , Mm          , Mm          , Mm          , Ds^Ft       , Mm          , Mm          , Mm          , Gs^Ft       , Gs          , Gs          , Re^Vct      , Re          , Gs          , Ww          , Ww          , Ww          , Ww          , Ww          , Ww          
Xu          , Xu          , Xu          , Cud         , Cud         , Cud         , Xu          , Cud         , Xu          , Mm^Xm       , Mm          , Hh          , Gs          , Gs          , Wwf         , Gs          , Rd          , Ds^Ft       , Ds          , Mm          , Ds^Ft       , Ds^Ft       , Ds          , Ds          , Ds          , Ds          , Dd^Dc       , Ds          , Rd          , Rd          , Wwf         , Wwf         , Ww          , Ds          , Re          , Gs          , Ww          , Ww^Vm       , Ww          , Ww          , Ww          , Ww          
Mm^Xm       , Xu          , Mm^Xm       , Xu          , Xu          , Xu          , Mm^Xm       , Xu          , Mm^Xm       , Mm^Xm       , Gs^Ft       , Gs          , Wwf         , Wwf         , Mm          , Gs          , Rd          , Rd          , Rd          , Rd          , Rd          , Dd^Do       , Rd          , Dd^Vda      , Rd          , Rd          , Rd          , Rd          , Mm          , Mm          , Mm          , Ww          , Ww          , Re          , Ww          , Gs          , Ww          , Ww          , Ww          , Ww          , Gs          , Ww          
Gs^Ft       , Mm^Xm       , Mm          , Mm^Xm       , Mm^Xm       , Mm^Xm       , Hh          , Mm^Xm       , Gs^Ft       , Hh          , Gs          , Gs          , Ww          , Mm          , Mm          , Mm          , Mm          , Ds          , Ds^Ft       , Ds          , Mm          , Rd          , Hd          , Rd          , Dd          , Dd^Ft       , Mm          , Mm          , Mm          , Mm          , Mm          , Mm          , Mm          , Re          , Ww          , Ww          , Ww          , Ww          , Gs          , Gs          , Gs          , Gs          
Gs          , Hh          , Gs          , Mm          , Mm          , Gs^Ft       , Gs          , Gs^Ft       , Gs          , Gs          , Ds          , Ww          , Ww          , Wwf         , Gs          , Mm          , Mm          , Mm          , Mm          , Mm          , Mm          , Mm          , Mm          , Dd          , Mm          , Mm          , Mm          , Mm          , Mm          , Mm          , Mm          , Mm          , Gs          , Re          , Re          , Mm          , Hh          , Hh^Fmw      , Gs          , Re^Gvs      , Re^Gvs      , Gs          
Gs          , Gs          , Gs          , Gs          , Gs          , Gs          , Gs          , Gs          , Hh          , Gs          , Gs          , Ww          , Ww          , Gs^Ft       , Gs          , Hh          , Mm          , Mm          , Mm          , Mm          , Mm          , Mm          , Mm          , Mm          , Mm          , Mm          , Mm          , Mm          , Mm          , Mm          , Mm          , Gs          , Re^Gvs      , Gs          , Gs          , Re          , Re          , Gs          , Gs          , Re^Gvs      , Gs          , Gs          
Mm          , Hh          , Gs^Ft       , Gs          , Gs          , Gs          , Gs          , Hh^Fms      , Mm          , Gs          , Wwf         , Ww          , Ww^Vm       , Ww          , Wwf         , Gs          , Gs          , Mm          , Mm          , Mm          , Gs          , Hh          , Gs          , Mm          , Mm          , Mm          , Gs          , Gs          , Gs          , Mm          , Gs          , Gs          , Re^Gvs      , Re^Gvs      , Gs          , Gs          , Re          , Gs          , Gs          , Gs          , Gs          , Gs          
Hh          , Gs^Ft       , Hh          , Gs          , Gs          , Gs          , Ce          , Gs          , Gs          , Gs          , Gs          , Ww          , Gs          , Ww          , Gs          , Gs          , Gs          , Gs          , Gs          , Gs          , Gs^Ft       , Gs          , Gs          , Mm          , Mm          , Mm          , Gs          , Gs          , Gs^Ft       , Gs          , Hh          , Gs          , Gs          , Gs          , Hh          , Gs          , Re          , Gs          , Gs          , Gs          , Gs          , Gs          
Gs^Ft       , Gs^Ft       , Hh^Vhh      , Re^Gvs      , Gs          , Gs          , Ce          , Re          , Gs          , Gs          , Gs          , Gs          , Gs          , Gs          , Gs          , Hh^Ft       , Gs          , Gs          , Gs          , Gs          , Hh          , Gs^Ft       , Hh          , Mm          , Mm          , Mm          , Gs^Gvs      , Gs          , Gs^Ft       , Hh          , Gs          , Gs          , Gs          , Hh^Fms      , Gs          , Gs          , Gs^Gvs      , Re          , Gs          , Gs          , Gs          , Gs          
Hh          , Gs^Ft       , Re^Gvs      , Re^Gvs      , Gs          , Ce          , Re^Vct      , Re          , Re          , Gs^Ft       , Re          , Gs          , Gs^Gvs      , Gs^Gvs      , Gs^Gvs      , Gs          , Gs          , Gs          , Re          , Re          , Re          , Hh^Ft       , Re          , Gs          , Re          , Gs^Gvs      , Gs^Vht      , Gs^Gvs      , Re          , Gs^Ft       , Re          , Gs          , Re          , Gs          , Gs^Gvs      , Gs^Vht      , Gs^Gvs      , Re          , Ch          , Ch          , Gs^Gvs      , Gs          
Mm          , Gs          , Gs          , Gs          , Gs          , 8 Ke        , Ce          , Ce          , Ce          , Re          , Gs          , Re          , Re          , Gs^Vht      , Re          , Re          , Re          , Re          , Gs^Gvs      , Gs^Vht      , Gs^Gvs      , Re          , Gs          , Re          , Gs          , Re          , Re          , Re          , Gs          , Re          , Gs          , Re          , Gs          , Re          , Re          , Gs^Gvs      , Re          , Re          , 3 Kh        , Ch          , Gs^Gvs      , Gs          
Gs          , Gs          , Gs          , Gs          , Gs          , Gs          , Gs          , Gs          , Gs          , Gs          , Gs          , Gs          , Gs          , Re          , Gs          , Gs          , Gs          , Gs          , Gs          , Gs^Gvs      , Re^Gvs      , Gs          , Gs          , Hh          , Hh          , Gs          , Mm          , Gs          , Re^Gvs      , Re^Vct      , Re^Gvs      , Gs          , Gs          , Gs          , Gs          , Re          , Gs          , Ch          , Ch          , Gs^Vht      , Gs^Gvs      , Gs^Gvs      
Hh^Ft       , Gs          , Gs^Ft       , Hh          , Hh^Ft       , Gs          , Gs          , Gs          , Gs          , Gs          , Re^Gvs      , Gs          , Gs          , Gs          , Hh          , Gs          , Gs          , Gs          , Gs          , Re^Gvs      , Gs          , Re^Gvs      , Gs          , Hh^Ft       , Hh          , Mm          , Mm          , Gs          , Gs          , Re^Gvs      , Re^Gvs      , Gs          , Hh          , Hh^Fms      , Gs          , Gs          , Gs          , Ch          , Gs^Gvs      , Gs^Gvs      , Gs^Gvs      , Gs          
Hh          , Hh          , Gs^Ft       , Gs^Ft       , Gs^Ft       , Gs^Ft       , Gs^Ft       , Gs          , Re^Gvs      , Re^Gvs      , Re^Gvs      , Gs          , Gs          , Gs^Ft       , Gs^Ft       , Gs^Ft       , Gs          , Mm          , Mm          , Gs          , Mm          , Gs          , Gs          , Gs^Ft       , Gs^Ft       , Gs^Ft       , Mm          , Mm          , Mm          , Gs          , Gs          , Gs          , Mm          , Hh          , Mm          , Gs          , Gs          , Gs          , Gs          , Gs          , Gs          , Gs          
