border_size=1
usage=map

Mm          , Mm          , Mm          , Mm          , Mm          , Mm          , Mm          , Mm          , Mm          , Mm          , Mm          , Mm          , Mm          , Mm          , Mm          , Mm          , Mm          , Mm          , Mm          , Mm^Xm       , Mm^Xm       , Mm^Xm       , Mm^Xm       , Mm^Xm       , Mm^Xm       , Mm^Xm       , Mm^Xm       , Mm^Xm       , Mm^Xm       , Mm^Xm       , Mm^Xm       , Mm^Xm       , Mm^Xm       , Mm^Xm       , Mm^Xm       , Mm^Xm       , Mm^Xm       , Mm^Xm       , Mm^Xm       , Mm^Xm       , Mm^Xm       , Mm^Xm       , Mm^Xm       , Mm^Xm       , Mm^Xm       , Mm^Xm       
Mm          , Mm          , Hh          , Hh          , Gs^Fp       , Hh          , Gs^Fp       , Hh^Uf       , Hh          , Hh          , Hh          , Mm          , Mm          , Mm          , Gg          , Hh          , Gg          , Hh^Uf       , Mm          , Mm^Xm       , Mm^Xm       , Mm^Xm       , Mm^Xm       , Mm^Xm       , Mm^Xm       , Mm^Xm       , Mm^Xm       , Mm^Xm       , Mm^Xm       , Mm^Xm       , Mm^Xm       , Mm^Xm       , Mm^Xm       , Mm^Xm       , Mm^Xm       , Mm^Xm       , Mm^Xm       , Mm^Xm       , Mm^Xm       , Mm^Xm       , Mm^Xm       , Mm^Xm       , Mm^Xm       , Mm^Xm       , Mm^Xm       , Mm^Xm       
Mm          , Mm          , Gs^Fp       , Gg          , Gg          , Gg          , Gg          , Gg          , Gg          , Gs^Fp       , Gg          , Mm          , Mm          , Gg          , Rd          , Gs^Fp       , Gs^Fp       , Gg          , Hh          , Mm          , Mm^Xm       , Mm^Xm       , Mm^Xm       , Mm^Xm       , Mm^Xm       , Mm^Xm       , Mm^Xm       , Mm^Xm       , Mm^Xm       , Mm^Xm       , Mm^Xm       , Mm^Xm       , Mm^Xm       , Mm^Xm       , Mm^Xm       , Mm^Xm       , Mm^Xm       , Mm^Xm       , Mm^Xm       , Mm^Xm       , Mm^Xm       , Mm^Xm       , Mm^Xm       , Mm^Xm       , Mm^Xm       , Mm^Xm       
Gs^Fmw      , Hh          , Gg          , Gg          , Hh^Fp       , Gg          , Re^Gvs      , Gg^Vo       , Re^Gvs      , Gg          , Hh          , Mm          , Ch          , 3 Kh        , Ch          , Rd          , Rd          , Gg          , Gg          , Mm          , Mm          , Mm^Xm       , Mm^Xm       , Mm^Xm       , Mm^Xm       , Mm^Xm       , Mm^Xm       , Mm^Xm       , Mm^Xm       , Mm^Xm       , Mm^Xm       , Mm^Xm       , Mm^Xm       , Mm^Xm       , Mm^Xm       , Mm^Xm       , Mm^Xm       , Mm^Xm       , Mm^Xm       , Mm^Xm       , Mm^Xm       , Mm^Xm       , Mm^Xm       , Mm^Xm       , Mm^Xm       , Mm^Xm       
Gs^Fmw      , Gg          , Gs^Fp       , Gs^Fp       , Ss          , Gs^Fp       , Gg          , Re^Gvs      , Gg          , Gg          , Hh          , Ch          , Gg          , Rd          , Rd          , Ch          , Rd          , Rd          , Rd          , Gg          , Hh          , Mm          , Mm^Xm       , Mm^Xm       , Mm^Xm       , Mm^Xm       , Mm^Xm       , Mm^Xm       , Mm^Xm       , Mm^Xm       , Mm^Xm       , Mm^Xm       , Mm^Xm       , Mm^Xm       , Mm^Xm       , Mm^Xm       , Mm^Xm       , Mm^Xm       , Mm^Xm       , Mm^Xm       , Mm^Xm       , Mm^Xm       , Mm^Xm       , Mm^Xm       , Mm^Xm       , Mm^Xm       
Rd          , Hh^Fp       , Gs^Fp       , Ss          , Gs^Fp       , Gs^Fp       , Gg          , Gg          , Gs^Fp       , Gg          , Gg          , Ch          , Gg          , Rd          , Gg          , Ch          , Ggf         , Ggf         , Ggf         , Rd          , Ggf         , Mm          , Mm          , Mm^Xm       , Mm^Xm       , Mm^Xm       , Mm^Xm       , Mm^Xm       , Mm^Xm       , Mm^Xm       , Mm^Xm       , Mm^Xm       , Mm^Xm       , Mm^Xm       , Mm^Xm       , Mm^Xm       , Mm^Xm       , Mm^Xm       , Mm^Xm       , Mm^Xm       , Mm^Xm       , Mm^Xm       , Mm^Xm       , Mm^Xm       , Mm^Xm       , Mm^Xm       
Rd          , Rd          , Gg          , Ss          , Gs^Fp       , Ss          , Gg          , Gs^Fp       , Gs^Fmw      , Gg          , Gs^Fp       , Gg          , Rd          , Rd          , Gs^Fmw      , Gg          , Gg          , Gg          , Gg          , Rd          , Rd          , Ggf         , Ggf         , Hh          , Hh          , Mm          , Mm          , Mm^Xm       , Mm^Xm       , Mm^Xm       , Mm^Xm       , Mm^Xm       , Mm^Xm       , Mm^Xm       , Mm^Xm       , Mm^Xm       , Mm^Xm       , Mm^Xm       , Mm^Xm       , Mm^Xm       , Mm^Xm       , Mm^Xm       , Mm^Xm       , Mm^Xm       , Mm^Xm       , Mm^Xm       
Gs^Fp       , Rd          , Rd          , Hh^Fp       , Gs^Fp       , Ss          , Gg          , Gs^Fp       , Hh^Uf       , Ss          , Rd          , Rd          , Gs^Fp       , Gg          , Hh^Fp       , Hh^Fp       , Ss          , Hh^Fp       , Ss^Fp       , Gg          , Gg          , Rd          , Rd          , Gg          , Gg          , Gg          , Gg          , Mm          , Mm          , Mm          , Mm          , Mm^Xm       , Mm^Xm       , Mm^Xm       , Mm^Xm       , Mm^Xm       , Mm^Xm       , Mm^Xm       , Mm^Xm       , Mm^Xm       , Mm^Xm       , Mm^Xm       , Mm^Xm       , Mm^Xm       , Mm^Xm       , Mm^Xm       
Ss          , Gs^Fp       , Rd          , Gs^Fp       , Gs^Fmw      , Hh          , Gs^Fmw      , Gg          , Gg          , Gs^Fp       , Rd          , Hh          , Gs^Fp       , Gg          , Ss^Bw\      , Ss^Fp       , Ss          , Ss^Fp       , Ss^Uf       , Ss          , Gs^Fmw      , Ggf         , Rd          , Gg          , Re^Gvs      , Re^Gvs      , Re^Gvs      , Gg^Uf       , Hh          , Mm          , Mm^Xm       , Mm^Xm       , Mm^Xm       , Mm^Xm       , Mm^Xm       , Mm^Xm       , Mm^Xm       , Mm^Xm       , Mm^Xm       , Mm^Xm       , Mm^Xm       , Mm^Xm       , Mm^Xm       , Mm^Xm       , Mm^Xm       , Mm^Xm       
Ss          , Ss          , Hh^Fp       , Rd          , Gs^Fp       , Gs^Fmw      , Gs^Fp       , Gg          , Gg          , Gg          , Rd          , Ss          , Gs^Fp       , Hh^Fp       , Ss^Fp       , Ss^Bw\      , Ss^Bw|      , Ss^Fp       , Ss          , Ss          , Gg          , Ggf         , Rd          , Ggf         , Gg          , Gg^Vo       , Gg          , Gg          , Hh          , Mm          , Mm^Xm       , Mm^Xm       , Mm^Xm       , Mm^Xm       , Mm^Xm       , Mm^Xm       , Mm^Xm       , Mm^Xm       , Mm^Xm       , Mm^Xm       , Mm^Xm       , Mm^Xm       , Mm^Xm       , Mm^Xm       , Mm^Xm       , Mm^Xm       
Gs^Fp       , Ss          , Gs^Fp       , Rd          , Rd          , Gs^Fp       , Gs^Fp       , Ss          , Gs^Fp       , Rd          , Gs^Fp       , Gs^Fp       , Hh          , Ss          , Ss^Bw|      , Ss^Bw/      , Ss^Fp       , Ss^Fp       , Gg          , Gg          , Re^Gvs      , Gg          , Gg          , Rd          , Gg^Uf       , Gg          , Gg          , Gg          , Hh          , Mm          , Mm^Xm       , Mm^Xm       , Mm^Xm       , Mm^Xm       , Mm^Xm       , Mm^Xm       , Mm^Xm       , Mm^Xm       , Mm^Xm       , Mm^Xm       , Mm^Xm       , Mm^Xm       , Mm^Xm       , Mm^Xm       , Mm^Xm       , Mm^Xm       
Ss          , Ss          , Gs^Fp       , Gs^Fp       , Rd          , Gs^Fp       , Gg          , Gs^Fmw      , Hh          , Rd          , Rd          , Gs^Fp       , Gs^Fmw      , Ss          , Ss^Bw\      , Ss          , Gg          , Gg          , Ss          , Gg^Vo       , Re^Gvs      , Re^Gvs      , Gg          , Rd          , Rd          , Rd          , Rd          , Gg          , Rd          , Mm          , Mm          , Mm^Xm       , Mm^Xm       , Mm^Xm       , Mm^Xm       , Mm^Xm       , Mm^Xm       , Mm^Xm       , Mm^Xm       , Mm^Xm       , Mm^Xm       , Mm^Xm       , Mm^Xm       , Mm^Xm       , Mm^Xm       , Mm^Xm       
Gg          , Hh^Fp       , Rd          , Rd          , Gs^Fp       , Gg^Vo       , Ss^Fp       , Ss^Fp       , Ss^Fp       , Ss^Fp       , Rd          , Gs^Fp       , Gs^Fp       , Gs^Fp       , Hh^Fp       , Gg          , Gg          , Gs^Fp       , Gs^Fp       , Gg          , Gg          , Gg          , Rd          , Rd          , Gg          , Gg          , Hh^Fds      , Rd          , Gg          , Rd          , Rd          , Mm          , Mm          , Mm^Xm       , Mm^Xm       , Mm^Xm       , Mm          , Mm^Xm       , Mm          , Mm          , Mm          , Mm^Xm       , Mm^Xm       , Mm^Xm       , Mm^Xm       , Mm^Xm       
Gg          , Gg          , Rd          , Rd          , Hh^Uf       , Ss          , Ss^Fp       , Ss^Fp       , Ss^Fp       , Ss^Fp       , Hh          , Rd          , Gs^Fp       , Gs^Fp       , Gg          , Gg          , Gg          , Gs^Fp       , Gg          , Gg          , Rd          , Rd          , Gg          , Gg          , Gg^Uf       , Gs^Fds      , Hh          , Gs^Fds      , Ww          , Gg          , Rd          , Hh          , Hh^Fds      , Mm          , Mm          , Mm          , Mm          , Mm          , Ggf         , Hh          , Hh^Fds      , Mm          , Mm          , Mm^Xm       , Mm^Xm       , Mm^Xm       
Gs^Fp       , Gg          , Gg          , Gs^Fp       , Ss          , Ss          , Ss^Fp       , Ss          , Ss^Fp       , Gg          , Rd          , Rd          , Gg          , Gs^Fp       , Rd          , Gs^Fp       , Rd          , Gg          , Rd          , Rd          , Gg          , Gg          , Gg^Vo       , Ds          , Ww          , Ww          , Hh          , Mm          , Ww          , Gg^Vo       , Gg          , Rd          , Gg          , Hh          , Hh^Fds      , Hh          , Ggf         , Ggf         , Ggf         , Ggf         , Gg^Vo       , Gs^Fds      , Hh          , Mm          , Mm          , Mm^Xm       
Ss          , Ss          , Gg          , Hh          , Ss          , Ss          , Ss^Fp       , Ss          , Ss^Fp       , Gg          , Rd          , Rd          , Rd          , Rd          , Gg          , Rd          , Gs^Fp       , Rd          , Gg          , Gg          , Re^Gvs      , Gg          , Ds          , Ww          , Ww          , Ggf         , Mm          , Ww          , Ww          , Ds          , Gg          , Rd          , Rd          , Gg          , Gg          , Gg          , Mm          , Gg          , Gg          , Gs^Fds      , Gg          , Ggf         , Gg^Uf       , Hh^Fds      , Mm          , Mm          
Ss          , Gg          , Gg          , Ss          , Ss^Fp       , Ss^Uf       , Ss^Fp       , Ss          , Ss^Fp       , Gg          , Rd          , Gs^Fp       , Gg          , Gs^Fp       , Gg          , Hh          , Mm          , Gs^Fp       , Gg^Uf       , Gg          , Re^Gvs      , Gg          , Gg          , Ww          , Gg          , Gg          , Hh          , Ww          , Ww          , Ww          , Gg          , Gg          , Gg          , Rd          , Gg          , Hh          , Mm          , Mm          , Mm          , Gg          , Re^Gvs      , Re^Gvs      , Gg^Uf       , Mm          , Mm          , Mm          
Ss          , Gs^Fp       , Gg          , Gs^Fp       , Hh          , Ss^Fp       , Hh          , Ss^Fp       , Gs^Fp       , Rd          , Gs^Fp       , Gs^Fp       , Gg          , Gs^Fp       , Gg          , Hh          , Gs^Fp       , Gs^Fp       , Ss          , Gg          , Gg          , Re^Gvs      , Gg          , Gg          , Hh          , Gg          , Gg          , Hh^Fds      , Gg          , Gg          , Gg          , Ggf         , Gg          , Rd          , Gg          , Ggf         , Hh^Fds      , Mm          , Hh^Fds      , Gg          , Gg          , Re^Gvs      , Gg^Uf       , Hh          , Mm          , Mm          
Ss          , Ss          , Gg          , Gs^Fp       , Hh          , Gs^Fmw      , Gs^Fmw      , Gs^Fp       , Rd          , Rd          , Gs^Fp       , Hh          , Gg          , Gs^Fp       , Gs^Fp       , Gg          , Gs^Fp       , Gs^Fmw      , Hh          , Gg          , Re^Gvs      , Gg          , Ww          , Ww          , Mm          , Ww          , Ww          , Gg          , Gg          , Gg          , Gg          , Gg          , Gg          , Rd          , Rd          , Gg          , Gg          , Gs^Fds      , Hh          , Gg^Vo       , Gg          , Re^Gvs      , Re^Gvs      , Hh^Fds      , Hh          , Mm          
Ss          , Gs^Fp       , Gg          , Gs^Fp       , Ss          , Mm          , Gs^Fp       , Rd          , Gg^Vo       , Gg          , Chs         , Ss          , Gg^Uf       , Gg          , Gg          , Gg          , Gg          , Gs^Fp       , Gg          , Gg          , Re^Gvs      , Gg          , Gg          , Ww          , Ww          , Ww          , Ww          , Gs^Fds      , Gg          , Gg          , Gg          , Gs^Fds      , Gg          , Gg          , Gg          , Rd          , Gs^Fds      , Gg          , Mm          , Hh          , Gs^Fds      , Gg          , Re^Gvs      , Gg^Uf       , Gs^Fds      , Mm          
Ss          , Gg          , Gg          , Hh^Vo       , Gs^Fp       , Gs^Fp       , Rd          , Rd          , Gg          , Gg          , Gs^Fp       , Gs^Fp       , Ss          , Gs^Fp       , Ss          , Gg          , Gg          , Gg          , Gg          , Gg          , Gg          , Re^Gvs      , Gg          , Ds          , Gg^Vo       , Gs^Fds      , Gs^Fds      , Gs^Fds      , Gg          , Re^Gvs      , Re^Gvs      , Gg          , Gg          , Gg          , Gg          , Rd          , Gg          , Hh          , Mm          , Mm          , Gs^Fds      , Gg          , Gg          , Gg^Vo       , Gs^Fds      , Gs^Fds      
Gs^Fp       , Gg          , Gg          , Gs^Fp       , Rd          , Rd          , Rd          , Gg          , Gg          , Gg          , Gg          , Gs^Fmw      , Mm          , Hh^Fp       , Hh          , Hh^Fp       , Mm          , Mm          , Mm          , Gg          , Hh          , Gg          , Re^Gvs      , Gg          , Gg          , Gs^Fds      , Hh          , Hh^Uf       , Gg          , Re^Gvs      , Gg          , Gg          , Hh          , Gs^Fds      , Ggf         , Rd          , Rd          , Mm          , Hh^Fds      , Hh          , Gg          , Gg          , Gg          , Hh^Fds      , Hh          , Gs^Fds      
Gg          , Gg          , Gg          , Gg          , Gg          , Gg          , Gg          , Gg          , Hh          , Gg          , Mm          , Mm^Vhh      , Mm          , Mm          , Mm          , Mm          , Mm          , Mm          , Gg^Uf       , Gg          , Gg          , Gg          , Re^Gvs      , Re^Gvs      , Gg          , Gg          , Gg          , Gg          , Gg          , Gg          , Gg          , Gs^Uf       , Hh^Fds      , Mm          , Ggf         , Gg          , Rd          , Gg          , Gg          , Gg          , Gg          , Gg          , Gs^Fds      , Ggf         , Hh^Uf       , Gs^Fds      
Gg          , Gg          , Gg          , Gg          , Gg          , Gg          , Hh^Fp       , Hh^Fp       , Mm          , Mm          , Mm^Xm       , Mm^Xm       , Mm^Xm       , Mm^Xm       , Mm^Xm       , Mm^Xm       , Mm          , Hh^Fp       , Hh          , Gg          , Gg          , Gg          , Gg          , Gg          , Gg          , Re^Gvs      , Gg          , Gg          , Gs^Fds      , Gg          , Gg          , Gs^Fds      , Ggf         , Ggf         , Gg          , Gg          , Rd          , Ggf         , Gg          , Re^Gvs      , Gg          , Gs^Fds      , Ggf         , Gs^Fds      , Gs^Fds      , Hh          
Gg          , Gg          , Gg          , Gg^Vh       , Ch          , Ch          , Mm          , Mm          , Mm^Xm       , Mm^Xm       , Xu          , Xu          , Xu          , Xu          , Xu          , Mm^Xm       , Mm^Xm       , Mm          , Hh^Fp       , Hh^Vo       , Gg          , Ggf         , Wwf         , Gs^Fds      , Ww          , Gg          , Gg          , Gg          , Gg          , Gg          , Gg          , Gg          , Gg          , Gg          , Gg          , Rd          , Ggf         , Ggf         , Re^Gvs      , Re^Gvs      , Gg^Vo       , Gg          , Mm          , Mm          , Mm          , Hh          
Gg          , Gg          , Kh          , Ch          , Mm          , Mm          , Mm^Xm       , Mm^Xm       , Xu          , Xu          , Uu          , Xu          , Xu          , Xu          , Xu          , Xu          , Mm          , Mm          , Gg          , Gg          , Gg          , Ggf         , Ggf         , Ww          , Ww          , Ww          , Gg          , Gg          , Gs^Fds      , Ggf         , Ggf         , Gg          , Gg          , Gg          , Gg          , Rd          , Ggf         , Gg          , Gg          , Gg          , Hh          , Hh^Fms      , Ww          , Mm          , Mm          , Hh          
Gg          , Gg          , Ch          , Ch          , Mm          , Mm^Xm       , Xu          , Xu          , Xu          , Uu          , Ur          , Xu          , Uu^Vud      , Xu          , Uh          , Mm          , Gg          , Gg          , Gg          , Gg          , Gg          , Gg          , Ggf         , Ww          , Hh^Fms      , Gg^Vo       , Gg          , Hh          , Mm          , Ggf         , Gg          , Gg          , Re^Gvs      , Re^Gvs      , Gg          , Rd          , Rd          , Rd          , Ch          , Hh^Fds      , Hh          , Hh^Fms      , Ww          , Mm          , Mm          , Mm          
Gg          , Gg          , Ch          , Mm          , Mm^Xm       , Mm^Xm       , Xu          , Xu          , Xu          , Uu          , Ur          , Ur          , Ur          , Uu^Uf       , Ur          , Ur^Ii       , Ur^Ii       , Gg          , Gg^Vo       , Gs^Fds      , Gs^Fds      , Gg          , Ggf         , Wwf         , Wwf         , Gg          , Gg          , Gs^Fds      , Hh          , Hh^Fms      , Gg          , Gg          , Gg^Vo       , Re^Gvs      , Re^Gvs      , Gg          , Rd          , Rd          , Ch          , Ch          , 4 Kh        , Hh          , Hh^Uf       , Ww          , Mm          , Mm          
Gg          , Gg^Vh       , Gg          , Mm          , Mm^Xm       , Xu          , Xu          , Xu          , Uu          , Uu          , Ur          , Ur          , Cud         , Ur          , Xu          , Ur          , Uu          , Xu          , Xu          , Hh^Fds      , Gg^Uf       , Gg          , Gg          , Ggf         , Wwf         , Gg          , Gg          , Gg          , Gg          , Gg          , Gg          , Gg          , Gg          , Re^Gvs      , Gg          , Gg          , Gg          , Rd          , Ch          , Ch          , Gg^Uf       , Hh          , Hh^Fds      , Mm          , Mm          , Mm          
Gg          , Gg          , Gg          , Mm          , Mm^Xm       , Xu          , Xu          , Uu^Uf       , Xu          , Ur          , Cud         , Cud         , Xu          , Ur          , Ur          , Ur          , Uu^Vud      , Xu          , Ur^Ii       , Xu          , Gg          , Gg          , Gs^Fds      , Wwf         , Hh          , Gg          , Gs^Fds      , Gg          , Gg          , Gg          , Gg          , Gg          , Wwf         , Gg          , Wwr         , Gg          , Ds          , Gg          , Chw         , Gg^Vo       , Gg          , Hh          , Hh^Fms      , Mm          , Mm          , Ww          
Gg          , 1 Gg        , Gg          , Mm          , Mm^Xm       , Xu          , Xu          , Uu          , Cud         , Ur          , Cud         , Xu          , Ur          , Xu          , Ur          , Ur          , Ur          , Ur          , Gg          , Gg          , Gg          , Gs^Fds      , Hh^Fds      , Wwf         , Gg          , Gg          , Wwf         , Hh^Fms      , Gg          , Gg          , Wwf         , Wwf         , Ww          , Ww          , Ww          , Ww          , Ww          , Wwf         , Ggf         , Gg          , Ggf         , Ggf         , Gs^Fds      , Mm          , Gs^Fds      , Ww          
Gg          , Gg          , Mm          , Mm          , Mm^Xm       , Xu          , Uu          , Uu^Vud      , Xu          , Kud         , Wwf         , Cud         , Wwf         , Ur          , Uu          , Uu          , Uu          , Xu          , Gg^Uf       , Gg          , Gg          , Gs^Fds      , Gg          , Wwf         , Wwf         , Wwf         , Gg          , Gg          , Gg          , Wwf         , Ww          , Ww          , Ww          , Ww          , Wwr         , Ww          , Ww          , Ww          , Ww          , Ggf         , Ggf         , Ggf         , Ds          , Gs^Fds      , Ww          , Ww          
Mm          , Mm          , Mm^Xm       , Mm^Xm       , Xu          , Xu          , Ur          , Ur          , Wwf         , Wwf         , Ww          , Xu          , Xu          , Wwf         , Wwr         , Xu          , Xu          , Xu          , Wwf         , Gg^Vo       , Ds          , Gg          , Wwf         , Gg          , Wwf         , Wwf         , Wwr         , Wwf         , Wwr         , Wwr         , Ww          , Ww          , Wwr         , Ww^Vm       , Ww          , Ww          , Ww          , Ww          , Ww          , Wwf         , Ww          , Ds          , Ww          , Ww          , Ww          , Gs^Fds      
Mm^Xm       , Mm^Xm       , Mm^Xm       , Xu          , Xu          , 2 Ur        , Ww          , Wwf         , Ww          , Ww          , Ww          , Ww          , Ww          , Ww^Vm       , Ww          , Ww          , Ww          , Ww          , Ww          , Ww          , Ww          , Wwr         , Ww          , Wwr         , Ww          , Ww^Vm       , Ww          , Ww          , Ww          , Ww          , Ww          , Ww          , Wo          , Wo          , Wo          , Ww          , Ww          , Ww          , Ww          , Ww          , Gg          , Ww          , Ww          , Ww          , Mm          , Mm          
Ww          , Ww          , Ww          , Ww          , Ww          , Ww          , Ww          , Ww          , Ww          , Ww          , Ww          , Ww          , Ww          , Ww          , Ww          , Ww          , Ww          , Ww          , Ww          , Ww          , Ww          , Ww          , Ww          , Ww          , Ww          , Ww          , Ww          , Ww          , Ww          , Ww          , Ww          , Wo          , Wo          , Wo          , Wo          , Wo          , Wo          , Wwr         , Ww          , Gg          , Gg          , Mm          , Mm          , Mm          , Mm          , Mm          
